R 150 250

NO ./pics/eagle.png

SO ./pics/bluestone.png

WE ./pics/wood.png

C 51,198,227

EA ./pics/greystone.png
S ./pics/barrel.png
F 184,113,39

11111111111111111111111111111
10000000001100000002000000001
10110000011102000N02000010001
10010000000000000000000010001
10110000011100000000000010001
10000000001100000111011110001
11110111111111011100000010001
11110111111111011101010010001
11000000110101011100000010001
10000000000000001100000010001
10000000000000001102010020001
11000000110101000000000000001
11110111110101000000202000001
10000000001100000100000010001
10000000000000002000200001001
10000000001000010000000001001
10000000001101000000000000001
10000000000100000001010000001
11111111111111111111111111111