

EA      ./pics/greystone.png

R 250 250

NO      ./pics/eagle.png

F 56,     255, 39

SO ./pics/bluestone.png

WE ./pics/mossy.png

C 0,198,                    220


S ./pics/barrel.png

    11111  111111
    10001  100201
  111002111100001
  111110010000001
11100000000000001
12000000000010001
1000000E020000001
10200000000000001
10000002000000001
10000011111100001
1000001    100001
1000001    100001
1100101    111001
1000001    100001
1011111    100001
1000001    100001
1100001    100001
1111111    111111