R 500 500

NO ./pics/bluestone.png

SO ./pics/eagle.png

WE ./pics/mossy.png

EA ./pics/wood.png

S ./pics/pillar.png

F 0,0,0
C 255,255,255

    11111  111111
    10001  100201
  111000111100001
  111110010000001
11100000000000001
12000000000010001
10000000000000001111111111111111111
10200000000000S00000000000000000001
10000000000000000000000000000000001
10000011111100001111000111111100001    11111111111111111111
1000001    100001  10001     000001    10000000000000000001
1000001    100001  1000111111100001    10000111111111110001
1100101    111001  1000000000000001    100001         10021
1000001    100001  11111111111000011111100001111111   11111
1011111    100001            1000000000000000000011
1000001    100001            1111111111111111111111
1100001    100001
1111111    111111
