R 500 500
NO ./pics/bluestone.png
SO ./pics/eagle.png
WE ./pics/greystone.png
EA ./pics/redbrick.png
S ./pics/barrel.png
F 102,102,153
C 240,248,255

        1111111111111111111111111
        1000000000110000000000001
        1011000001110000002000001
        1001000000000000000000001
111111111011000001110000000000001
100000000011002001110111111111111
11110111111111011100000010001
11110111111111011101010010001
11000000110101011100000010001
100020W0200000001100020010001
10002000202000001101010010001
110000011101010111110111100111
11110111 1110101 101111010001
11111111 1111111 111111111111
