R 250 250
NO ./path_to_the_north_texture
SO ./path_to_the_south_texture
WE ./path_to_the_west_texture
EA ./path_to_the_east_texture
S ./path_to_the_sprite_texture
F 220,100,0
C 225,30,0

        1111111111111111111111111
        1000000000110000000000001
        1011000001110000002000001
        100100000000S000000000001
111111111011000001110000000000001
100000000001000001110111111111111
11000000110101011100000010001
110000011101101111101111000111
11110111 1110101 101111010001
11111111 1111111 111111111111
